########
#  .   #
# .$ . #
# $@$  #
# .$   #
#      #
########
