###########
#.       .#
#         #
#  $   $  #
#    @    #
#  $   $  #
#         #
#.       .#
###########
