#######
#  .  #
#  $  #
#.$@  #
#     #
#######
