##########
#. .  . .#
#        #
# $ $$ $ #
#        #
#   @    #
#        #
##########
