#######
#  .  #
#  $  #
#  @  #
#  $  #
#  .  #
#######
