#######
#     #
#  .  #
# $@  #
#     #
#######
