########
#.    .#
# $  $ #
# @    #
# $  $ #
#.    .#
########
