#######
# ... #
#     #
# $$$ #
#  @  #
#######
